0 0 0 0 0 0 0 0 0 0 0 0 0 0 0 0 0 0
0 1 1 1 1 1 1 1 1 1 1 1 1 1 1 1 1 0
0 1 1 6 1 3 3 3 3 3 3 3 1 1 1 1 1 0
0 1 1 3 1 1 1 1 1 1 1 1 1 3 1 1 3 0
0 3 1 1 3 1 1 1 1 3 1 3 1 1 1 3 1 0
0 1 3 1 1 1 1 3 1 1 1 1 1 1 3 1 1 0
0 1 3 1 1 1 1 1 1 3 1 3 1 5 1 3 1 0
0 1 1 1 3 1 3 3 1 1 1 1 1 1 1 3 1 0
0 3 1 3 1 1 1 1 3 1 1 1 3 1 3 1 1 0
0 3 1 1 1 1 1 3 1 3 3 1 1 1 1 1 1 0
0 1 1 3 2 1 1 1 3 1 1 1 3 1 1 1 7 0
0 0 0 0 0 0 0 0 0 0 0 0 0 0 0 0 0 0